AAAAAAAAAAAAAAAAAAAAAAAAAAAAAAAAAAAAAAAAAAAAAAAAAA
A                                                A
A                                                A
A                                                A
A                                                A
A                                                A
A                                                A
A                                                A
A                                                A
A                                                A
A                                                A
A                                                A
AD                                               A
A                                                A
AAA      oooo   AAA                              A
A                                                A
A       AAAAAA                                   A
A                                                A
AAAAA                                            A
A                     oooooo                     A
A             AAAA                               A
AAAAAAAAAAAAAAAAAAAAAAAAAAAAAAAAAAAAAAAAAAAAAAAAAA