AAAAAAAAAAAAAAAAAAAAAAAAAAAAAAAAAAAAAAA
A                                     A
A                                     A
A                                     A
A                                     A
A                                     A
A                                     A
A                                     A
A                                     A
A                                     A
A                                     A
A                                     A
A                AAA                  A
A                     AAAA            A
AAAAA    oooo   AAA                   A
A                                     A
A       AAAAAA                        A
A                                     A
AAAAA                                 A
A                     oooooo          A
A              AAAA                   A
AAAAAAAAAAAAAAAAAAAAAAAAAAAAAAAAAAAAAAA