AAAAAAAAAAAAAAAAAAAAAAAAAAAAAAAAAAAAAAAAAAAAAAAAAA
A                                                A
A                                                A
A                                                A
A                                                A
A            A  A                                A
A            A  A                                A
A            AAAA                                A
A               A                                A
A               A                                A
A                                                A
A                                                A
A                                                A
A                                                A
A                                                A
A                                                A
A                                                A
A                                                A
A                                                A
A                                                A
A                                                A
AAAAAAAAAAAAAAAAAAAAAAAAAAAAAAAAAAAAAAAAAAAAAAAAAA